1 1 1 1 1 1 1 1 1 1 1 1 1 1 1 1 1 1 1 1 1 1 1 1 1 1 1 1 1 1 1 1 1 1 1 1 1 1
1 6 8 8 8 8 8 8 8 8 8 8 8 8 8 8 8 8 8 8 8 8 8 8 8 8 8 8 8 8 8 8 8 8 8 8 6 1
1 7 6 8 8 6 6 8 8 8 8 8 8 6 6 8 8 8 8 8 8 8 8 8 6 6 8 8 8 8 8 8 8 8 8 6 7 1
1 7 7 9 4 7 7 4 9 9 9 9 9 7 7 9 9 9 9 9 9 9 9 9 7 7 9 9 9 9 9 9 9 9 9 7 7 1
1 7 7 9 4 7 7 4 9 10 11 12 9 7 7 9 22 23 2 2 2 2 2 2 7 7 2 2 2 2 2 2 22 23 9 7 7 1
1 7 7 9 4 7 7 4 9 13 14 15 9 7 7 9 24 25 2 2 2 2 2 2 7 7 2 2 2 2 2 2 24 25 9 7 7 1
1 7 7 9 4 7 7 4 9 16 17 18 9 7 7 9 0 0 0 0 0 0 4 9 7 7 9 4 0 0 0 0 0 0 9 7 7 1
1 7 7 9 4 7 7 4 9 19 20 21 9 7 7 9 0 0 0 0 0 0 4 9 7 7 9 4 0 0 0 0 0 0 9 7 7 1
1 7 7 9 4 7 7 4 9 9 0 0 9 7 7 9 0 0 9 9 9 9 9 9 7 7 9 9 9 9 9 9 0 0 9 7 7 1
1 7 6 8 8 6 6 8 8 8 8 8 8 6 6 8 8 8 8 8 8 8 8 8 6 6 8 8 8 8 8 8 8 8 8 6 7 1
1 7 6 8 8 8 8 8 8 8 8 8 8 6 6 8 8 6 6 8 8 8 8 8 8 8 8 8 6 6 8 8 8 8 8 6 7 1
1 7 7 9 9 9 9 9 9 9 9 9 9 7 7 9 4 7 7 4 9 9 9 9 9 9 9 9 7 7 9 9 9 9 9 7 7 1
1 7 7 9 10 11 12 2 2 2 2 2 2 7 7 9 4 7 7 4 9 10 11 12 10 11 12 9 7 7 9 10 11 12 9 7 7 1
1 7 7 9 13 14 15 2 2 2 2 2 2 7 7 9 4 7 7 4 9 13 14 15 13 14 15 9 7 7 9 13 14 15 9 7 7 1
1 7 7 9 16 17 18 2 2 2 2 2 2 7 7 9 4 7 7 4 9 16 17 18 16 17 18 9 7 7 9 16 17 18 9 7 7 1
1 7 7 9 19 20 21 0 0 4 4 4 9 7 7 9 4 7 7 4 9 19 20 21 19 20 21 9 7 7 9 19 20 21 9 7 7 1
1 7 7 9 4 0 0 0 0 0 0 4 9 7 7 9 4 7 7 4 9 4 0 0 0 0 4 9 7 7 9 4 0 0 9 7 7 1
6 7 7 9 4 0 0 0 0 0 0 4 9 7 7 9 4 7 7 4 9 4 4 0 0 4 4 9 7 7 9 4 0 0 9 7 7 1
6 7 7 9 9 0 0 9 9 9 9 9 9 7 7 9 4 7 7 4 9 9 9 0 0 9 9 9 7 7 9 9 0 0 9 7 7 1
8 6 6 8 8 8 8 8 8 8 8 8 8 6 6 8 8 6 6 8 8 8 8 8 8 8 8 8 6 6 8 8 8 8 8 6 6 8
8 6 6 8 8 8 8 8 6 6 8 8 8 8 8 8 8 8 8 8 6 6 8 8 8 8 8 8 8 8 8 8 8 8 8 6 6 8
1 7 7 9 9 9 9 9 7 7 9 9 9 9 9 9 9 9 9 9 7 7 9 9 9 9 9 9 9 9 9 9 9 9 9 7 7 1
1 7 7 9 10 11 12 9 7 7 2 2 2 2 2 2 10 11 12 9 7 7 9 10 11 12 9 10 11 12 9 10 11 12 9 7 7 1
1 7 7 9 13 14 15 9 7 7 2 2 2 2 2 2 13 14 15 9 7 7 9 13 14 15 9 13 14 15 9 13 14 15 9 7 7 1
1 7 7 9 16 17 18 9 7 7 2 2 2 2 2 2 16 17 18 9 7 7 9 16 17 18 9 16 17 18 9 16 17 18 9 7 7 1
1 0 0 4 19 20 21 4 0 0 4 4 4 4 0 0 19 20 21 4 0 0 4 19 20 21 4 19 20 21 4 19 20 21 4 0 0 1
1 0 0 0 0 0 0 0 0 0 0 0 0 0 0 0 0 0 0 0 0 0 0 0 0 0 0 0 0 0 0 0 0 0 0 0 0 1
1 0 0 0 0 0 0 0 0 0 0 0 0 0 0 0 0 0 0 0 0 0 0 0 0 0 0 0 0 0 0 0 0 0 0 0 0 1
1 0 0 4 4 4 4 4 4 4 4 4 4 0 0 4 4 4 4 4 4 4 4 4 4 4 4 4 0 0 4 4 4 4 4 0 0 1
1 0 0 4 10 11 12 22 23 10 11 12 4 0 0 2 2 2 2 2 2 2 2 22 23 22 23 4 0 0 4 10 11 12 4 0 0 1
1 0 0 4 13 14 15 24 25 13 14 15 4 0 0 2 2 2 2 2 2 2 2 24 25 24 25 4 0 0 4 13 14 15 4 0 0 1
1 0 0 4 16 17 18 0 0 16 17 18 4 0 0 4 10 11 12 4 4 2 2 0 0 0 0 4 0 0 4 16 17 18 4 0 0 1
1 0 0 4 19 20 21 0 0 19 20 21 4 0 0 4 13 14 15 4 4 2 2 0 0 0 0 4 0 0 4 19 20 21 4 0 0 1
1 0 0 4 0 0 0 0 0 0 0 0 4 0 0 4 16 17 18 0 0 0 0 0 0 0 4 4 0 0 4 0 0 0 4 0 0 1
1 0 0 4 0 0 0 0 0 0 0 0 4 0 0 4 19 20 21 0 0 0 0 0 0 0 4 4 0 0 4 0 0 0 4 0 0 1
1 0 0 4 4 4 4 0 0 4 4 4 4 0 0 4 4 4 4 4 4 4 4 4 0 0 4 4 0 0 4 4 0 0 4 0 0 1
1 0 0 0 0 0 0 0 0 0 0 0 0 0 0 0 0 0 0 0 0 0 0 0 0 0 0 0 0 0 0 0 0 0 0 0 0 1
1 0 0 0 0 0 0 0 0 0 0 0 0 0 0 0 0 0 0 0 0 0 0 0 0 0 0 0 0 0 0 0 0 0 0 0 0 1
1 1 1 1 1 1 1 1 1 1 1 1 1 1 1 1 1 1 1 1 1 1 1 1 1 1 1 1 1 1 1 1 1 1 1 1 1 1
1 1 1 1 1 1 1 1 1 1 1 1 1 1 1 1 1 1 1 1 1 1 1 1 1 1 1 1 1 1 1 1 1 1 1 1 1 1